!Microsoft IME Dictionary Tool
!Version:
!Format:WORDLIST
!User Dictionary Name: C:\Users\anonymous\AppData\Roaming\Microsoft\IMJP14\imjp14cu.dic
!Output File Name: C:\Users\anonymous\Documents\output1.txt
!DateTime: 2013年07月17日 21:26

かんたいこれくしょん	艦隊これくしょん	固有名詞
かんこれ	艦これ	固有名詞
かんむす	艦娘	名詞

かむらんはんとう	カムラン半島	地名その他
ばしーとう	バシー島	地名その他
おりょーるかい	オリョール海	地名その他
もーれいかい	モーレイ海	地名その他
きすとう	キス島	地名その他
あるふぉんしーの	アルフォンシーノ	地名その他
じゃむとう	ジャム島	地名その他
かれーよう	カレー洋	地名その他
りらんかとう	リランカ島	地名その他
かすがだま	カスガダマ	地名その他
さんごしょとう	珊瑚諸島	地名その他
さぶとう	サブ島	地名その他

べーぐるわん	ベーグル湾	地名その他
あんずかんしょう	アンズ環礁	地名その他
すてびあかい	ステビア海	地名その他
ころねはいからとう	コロネハイカラ島	地名その他
ばにらわん	バニラ湾	地名その他

こんさくせん	渾作戦	固有名詞
ふんどしさくせん	褌作戦	固有名詞

たんじゅうじん	単縦陣	名詞
たんじゅう	単縦	名詞
ふくじゅうじん	複縦陣	名詞
ふくじゅう	複縦	名詞
りんけいじん	輪形陣	名詞
りんけい	輪形	名詞
ていけいじん	梯形陣	名詞
ていけい	梯形	名詞
たんおうじん	単横陣	名詞
たんおう	単横	名詞

どうこうせん	同航戦	名詞
どうこう	同航	名詞
はんこうせん	反航戦	名詞
はんこう	反航	名詞
てぃーじせん	T字戦	名詞
ｔじせん	T字戦	名詞
てぃーじ	T字	名詞
ｔじ	T字	名詞
てぃーじゆうり	T字有利	名詞
ｔじゆうり	T字有利	名詞
てぃーじふり	T字不利	名詞
ｔじふり	T字不利	名詞

えらーむすめ	エラー娘	名詞
ずかんむすめ	図鑑娘	名詞
めんてむすめ	メンテ娘	名詞
あくせすむすめ	アクセス娘	名詞

ねこつるし	猫吊るし	固有名詞
ねこどげざ	猫土下座	固有名詞
ねこまわし	猫回し	固有名詞

ちんじゅふ	鎮守府	名詞
けいびふ	警備府	名詞
よこちん	横鎮	固有名詞
くれちん	呉鎮	固有名詞
させちん	佐世鎮	固有名詞
さちん	佐鎮	固有名詞
まいちん	舞鎮	固有名詞
とらっく	トラック	地名その他
りんが	リンガ	地名その他
しょーとらんど	ショートランド	地名その他
ぶいん	ブイン	地名その他
たういたうい	タウイタウイ	地名その他
ひとかっぷ	単冠	地名その他
ひとかっぷわん	単冠湾	地名その他
ぱらむしる	幌筵	地名その他
ぱらむしるとう	幌筵島	地名その他

ばつびょう	抜猫	さ変名詞

きゅうかんび	休艦日	名詞

らいそう	雷装	名詞

しんかいせいかん	深海棲艦	名詞

かい	改	名詞
かいに	改二	名詞
かいにこう	改二甲	名詞
こう	甲	名詞
こう	航	名詞
こうかい	航改	名詞
こうかいに	航改二	名詞

いっこうせん	一航戦	固有名詞
にこうせん	二航戦	固有名詞
さんこうせん	三航戦	固有名詞
よんこうせん	四航戦	固有名詞
ごこうせん	五航戦	固有名詞

にすいせん	二水戦	固有名詞

こかん	個艦	名詞
たんかん	単艦	名詞

ちゅうせん	昼戦	名詞

きょうどう	嚮導	さ変名詞
だんちゃく	弾着	さ変名詞
しょくせつ	触接	さ変名詞

せいき	棲鬼	名詞
せいおに	棲鬼	名詞
せいき	棲姫	名詞
せいひめ	棲姫	名詞
せいせんき	棲戦鬼	名詞
せいせんおに	棲戦鬼	名詞
せいせんき	棲戦姫	名詞
せいせんひめ	棲戦姫	名詞
すいき	水鬼	名詞
すいおに	水鬼	名詞

ほっぽ	ほっぽ	人名

ぷりえーぜ	プリエーゼ	人名
えくさ	江草	姓
