!Microsoft IME Dictionary Tool
!Version:
!Format:WORDLIST
!User Dictionary Name: C:\Users\anonymous\AppData\Roaming\Microsoft\IMJP14\imjp14cu.dic
!Output File Name: C:\Users\anonymous\Documents\output1.txt
!DateTime: 2013年07月17日 21:26

かんせん	艦戦	名詞
かんばく	艦爆	名詞
かんこう	艦攻	名詞
かんてい	艦偵	名詞
すいせん	水戦	名詞
すいてい	水偵	名詞
すいかん	水観	名詞
やてい	夜偵	名詞
りくこう	陸攻	名詞
きょくせん	局戦	名詞
たんしんぎ	探信儀	名詞
ふんしんほう	噴進砲	名詞
すいじょうき	水上機	名詞
てっこうだん	徹甲弾	名詞
りゅうだん	榴弾	名詞
ばくせん	爆戦	名詞
こうしゃそうち	高射装置	名詞
ないかてい	内火艇	名詞
たいてい	大艇	名詞

ずいうん	瑞雲	固有名詞
こうひょうてき	甲標的	固有名詞
さいうん	彩雲	固有名詞
だいはつ	大発	固有名詞
れいてい	零偵	固有名詞
れいかん	零観	固有名詞
にしきたいてい	二式大艇	固有名詞
にしきだいてい	二式大艇	固有名詞
けいうん	景雲	固有名詞
すつーか	スツーカ	固有名詞
しゅとぅーか	シュトゥーカ	固有名詞
かみしゃ	カミ車	固有名詞
かごう	カ号	固有名詞
らいでん	雷電	固有名詞
ひえん	飛燕	固有名詞
かたりな	カタリナ	固有名詞
かたりな	Catalina	固有名詞
きっか	橘花	固有名詞

たんそう	単装	名詞
ふんしき	噴式	名詞

びしき	毘式	名詞
